type: polygons
w: 4
h: 4
Entity EFTA: (0, 3) - (0, 3) - (0, 4) - (2, 4)
Entity Nordic Council: (0, 2) - (0, 2) - (0, 3) - (2, 3) - (0, 4) - (0, 4)
Entity Eurozone: (0, 0) - (4, 0) - (0, 1) - (4, 1) - (1, 2) - (4, 2) - (2, 3) - (4, 3) - (3, 4) - (4, 4)
Entity Benelux: (3, 2) - (4, 2) - (3, 3) - (3, 3)
Entity Baltic Assembly: (1, 0) - (1, 0) - (1, 1) - (2, 1)
Statement AT                                                                                                                                                                                                                                                                                                                                                                                                                                                                                                                                                         : (3, 1)
Statement BE                                                                                                                                                                                                                                                                                                                                                                                                                                                                                                                                                         : (3, 2)
Statement CY                                                                                                                                                                                                                                                                                                                                                                                                                                                                                                                                                         : (2, 0)
Statement DK                                                                                                                                                                                                                                                                                                                                                                                                                                                                                                                                                         : (0, 2)
Statement EE: (2, 1)
Statement FI: (2, 3)
Statement FR: (1, 2)
Statement DE: (4, 1)
Statement GR                                                                                                                                                                                                                                                                                                                                                                                                                                                                                                                                                         : (4, 3)
Statement IE: (0, 0)
Statement IT: (2, 2)
Statement LV: (1, 1)
Statement LT: (1, 0)
Statement LU: (3, 3)
Statement MT: (3, 0)
Statement NL: (4, 2)
Statement PT: (3, 4)
Statement SK: (4, 0)
Statement SI                                                                                                                                                                                                                                                                                                                                                                                                                                                                                                                                                         : (4, 4)
Statement ES: (0, 1)
Statement SE: (1, 3)
Statement CH: (2, 4)
Statement NO: (0, 3)
Statement IS: (0, 4)
Statement LI: (1, 4)
